11111111111111111111
10000000000000000001
10000000000000000001
10011111000011111001
10011111000011111001
10011000000000011001
10011000011000011001
10011000011000011001
10000000011000000001
10000011111111000001
10000011111111000001
10000000011000000001
10011000011000011001
10011000011000011001
10011000000000011001
10011111000011111001
10011111000011111001
10000000000000000001
10000000000000000001
11111111111111111111